11111111111111111111
1000C0000010101C0101
10011110000000001001
1001C0000E001000P011
11111111111111111111