11111111111111111111111
10011111C1111111000C001
1001000000C000010100001
1001C111111111010100001
1001P1000000010C010E001
11111111111111111111111