111111111111111111111111111111111111
1000000010000000000000000000C0000001
1000C00000000000C0000000100000000001
100000000000100000000000000000000001
1000010000000000000C0000000100000001
100000000100000000E00000000000000001
10000000000000000000000000C000010001
1000PC000000000000000100000000000001
1000000010000C0000000000000C00000001
111111111111111111111111111111111111